1,6,1,2,3,4,52,56
2,5,1,2,3,4,23
3,2,3,23
4,5,1,2,4,52,56
5,4,5,9,26,42
6,11,6,7,8,14,24,25,40,41,67,68,69
7,11,6,7,8,14,24,25,40,41,67,68,69
8,11,6,7,8,14,24,25,40,41,67,68,69
9,4,5,9,26,42
10,6,10,13,27,44,63,65
11,11,11,12,28,61,62,71,72,73,74,75,82
12,11,11,12,28,61,62,71,72,73,74,75,82
13,5,10,13,27,43,63
14,11,6,7,8,14,24,25,40,41,67,68,69
15,11,15,16,17,32,33,36,38,51,53,54,55
16,11,15,16,17,32,33,36,38,51,53,54,55
17,11,15,16,17,32,33,36,38,51,53,54,55
18,13,18,19,20,30,31,39,45,47,48,49,50,57,70
19,11,18,19,20,30,31,39,47,49,50,57,70
20,13,18,19,20,30,31,39,45,47,48,49,50,57,70
21,4,21,22,29,58
22,4,21,22,29,58
23,11,6,7,8,14,24,25,40,41,67,68,69
24,11,6,7,8,14,24,25,40,41,67,68,69
25,4,5,9,26,42
26,7,10,13,27,43,44,63,65
27,11,11,12,28,61,62,71,72,73,74,75,82
28,4,21,22,29,58
29,13,18,19,20,30,31,39,45,47,48,49,50,57,70
30,13,18,19,20,30,31,39,45,47,48,49,50,57,70
31,11,15,16,17,32,33,36,38,51,53,54,55
32,11,15,16,17,32,33,36,38,51,53,54,55
33,6,1,2,3,4,52,56
34,2,35,66
35,2,34,37
36,2,34,37
37,11,15,16,17,32,33,36,38,51,53,54,55
38,11,15,16,17,32,33,36,38,51,53,54,55
39,13,18,19,20,30,31,39,45,47,48,49,50,57,70
40,5,1,2,3,4,52
41,11,6,7,8,14,24,25,40,41,67,68,69
42,11,6,7,8,14,24,25,40,41,67,68,69
43,4,5,9,26,42
44,7,10,13,27,43,44,63,65
45,2,46,64
46,10,18,19,20,30,31,45,47,48,49,50
47,10,18,19,20,30,31,45,47,48,49,50
48,13,18,19,20,30,31,39,45,47,48,49,50,57,70
49,13,18,19,20,30,31,39,45,47,48,49,50,57,70
50,13,18,19,20,30,31,39,45,47,48,49,50,57,70
51,11,18,19,20,30,31,39,47,49,50,57,70
52,4,1,2,52,56
53,11,15,16,17,32,33,36,38,51,53,54,55
54,11,15,16,17,32,33,36,38,51,53,54,55
55,11,15,16,17,32,33,36,38,51,53,54,55
56,11,15,16,17,32,33,36,38,51,53,54,55
57,4,21,22,29,58
58,2,59,60
59,2,59,60
60,11,11,12,28,61,62,71,72,73,74,75,82
61,12,11,12,28,61,62,71,72,73,74,75,76,82
62,7,10,13,27,43,44,63,65
63,5,10,13,27,43,63
64,6,10,13,27,44,63,65
65,2,46,64
66,11,6,7,8,14,24,25,40,41,67,68,69
67,11,6,7,8,14,24,25,40,41,67,68,69
68,11,6,7,8,14,24,25,40,41,67,68,69
69,2,35,66
70,11,18,19,20,30,31,39,47,49,50,57,70
71,11,11,12,28,61,62,71,72,73,74,75,82
72,11,11,12,28,61,62,71,72,73,74,75,82
73,11,11,12,28,61,62,71,72,73,74,75,82
74,11,11,12,28,61,62,71,72,73,74,75,82
75,11,11,12,28,61,62,71,72,73,74,75,82
76,12,11,12,28,61,62,71,72,73,74,75,76,82
77,5,12,71,75,76,77
78,2,78,80
79,3,78,79,80
80,2,76,77
81,2,78,80
82,2,81,83
83,0
